 W WAWXWXXXX
WXW WXXW AXA
XXXX W WWAWX
WXWXWXA WX W
 X XWS X AX 
 XXWX WXXXWX
A X WXX   AX
 WXW X XWX X