XX X X XX  X
  XX  XX XX 
XXX X X X XX
XXXX   XX X 
X  X XXXXXSX
 XX        X
X  XXXXXXXX 
  XXXXXXXXXX