 A W WX XWX 
XXXWW WWXWXW
XXXXWX X W W
XXX W   SXAX
XWXW XAXWWXW
  AWXXWX  WW
XX    XXXXXX
 WWWXX XW X 