CPC HFH P P 
WPP   XPWW  
HP  HPPHFXFC
  HPH  C HXX
 HPH  HXX HC
XC CCP    PF
F PPSPCWPX  
 CC H CHCX H