HXXCF X  CH 
C CXWFHCFPXX
 C X PF  CHX
XCX WXHC   H
WPS PPHPH FH
P CHXH  WHC 
 W  X  FCXCW
HFX X WX    