 XWAXXW X   
  WWXWWWWXWX
AWWX SWWXWWX
 WWWA W  XX 
 XXX WXXX XX
X XWAXWX  XX
WXAAXAXWXW  
X XX XXWXXXX