 XWXX FXW WX
 FFW XX FFXX
   WW XXXXXF
 F XW FSW WA
FF FXAWWX FW
FFWXXXX  XWX
X XXW FWXAFX
XXXF   XX  A