XX XXX X X X
 XX X XXXX X
  XXXX     X
XXX XXS  XXX
XXXXXXXXX X 
XXX     X XX
X X   X  XXX
X XXXXX  XXX