X FX XX WFXW
FXXXX  XXXW 
FWWXXXFW    
FW  X  WFX W
X X XF SWXF 
 FX  XX WXXX
WXX XF  XXXW
X WXFXXWW   