 HHP WFWX   
XHXPHWHH  XP
 XSHWF XFW H
CWH CXPCCPCW
XP    CFHX X
WXCCWW XWXPX
 HHC FFHPH  
P  HXCH W  H