XXXXXX XXX X
X XX XWXX XX
X X AAXXXAXX
X WS XWW W X
XWWXXWXWW XX
X WXX X A XW
W X XXA   XW
W WXX  XXXWW