 XP H  XPCXC
  HC  XCHCX 
H HPPHHHHHX 
 PXH XXPHCXH
HS C CCXPCC 
HH X XC H X 
PHHHXXC XCHC
 H H  CH PXX