 CC CXCCCCXC
XCXCX XX    
 CC X  C   C
X  CCCXCCXX 
CCXX  CCXCXC
 CCC  CSX C 
CC CC XCX  X
XX  XCXCCCXX