C HC CCHH HC
 H H  CCH HH
CC CHCHCCCCC
HCHHC CHHHHC
HH  H CSHHHC
CCCHH  HH HH
HHH  HCC HC 
HH H HCHHHHC