P X   X CXC 
 CXH CHCHP H
 XC C H CHCH
PCHHX HH  CX
 C SX HPH   
C XCXH XX XC
HXHHHXPXXH H
 PX XPC XXHP