XCCX   CCXXX
 CXCCCCX  CC
CX CCXCCX C 
C X  CXXSC X
C CC XXXCX  
CCCC    XX  
 C X X X X X
 XC  CCCC XC