FWXX WFWAWXF
XXWXW XXWX  
X FXXFW FX  
FWW  W  X X 
XFWWFW W FWX
 AX   XXSWWW
 X  FWWFXX F
XXWWX  XWX W