W FFX WF XXF
XF  W WFXXXF
XXX X FX X  
XW X WWXW XW
XFF   WWX WW
WFXXF SX F F
 XWXXFXWF WW
FXFWXX W XF 