 X X XXX XXX
XXXX  XX XXX
XXXX XXX   X
XXXXXX   XXX
XX    S XXXX
XX X X X  XX
X X   X XXXX
X XXXXX XXXX