H CCHC  C CH
HC  H HCCHCC
 HCHCHH H   
CSHCC  HHHC 
CH HCCC  CC 
   CCH HHHHH
 CHC HCCHC  
HC H H CHHHC