CHC  CC C  C
HCCH H  CHCH
  HCCCH HS H
H  CCCH CHCC
CHH HCCCHHCH
C H HCHCHCCH
   H    HHCC
HC  HCCHCHC 