  HHHC CCC  
H HHHCHH CHH
HC HHHC HHCH
  CH C H H C
HHC   HHCCCH
CHHHHHH HSC 
 CHHCH CCHHH
HC CH  CC HH