PCFH   CXPHC
  PCXPFHC XC
  X  XPFCHWH
XPXXCPCXWPCP
 PH PSHCFX C
P   HHC CP C
 CP PHPXHWPC
  XXXF  CCW 