   F WHXH W 
P  FXP C HH 
H XPCXCCXSP 
CFXPX  HXXC 
X  CX   C  H
CHH W C  XHC
HX XPXCH F X
PWC XXH H XW