CCCC C HH H 
  CH HC  CHC
H  H HH  CHC
HH HHC HHSHC
 C   CHH H H
HC C HC CCH 
 HHH   HC HH
HCCCCC H C  