H CCHXXCHHCC
HP CXXPCXC X
 P  HXXCHSC 
PXCCCXX CCXH
HCH PC  H  H
XC H  X PX C
CCX PX HCPPX
CHX XHHCH   