HHHXC CCXP H
PHXXXCXPXHX 
  XX CH X  X
 P H H XCPX 
HCSCHCHCCCXH
P H CHPHXC  
 XC X    XHP
CH  XCCH XXH