XX  W   FXA 
 XX  XW W XW
AWF XWXXX AW
X WWFSFW    
WF XWXWFWXWF
 FWX XXW XFX
X F  X XW WX
WFWXXXXWFFFA