FXX   WXXX W
 WX FWX WF  
 XXFXXF WF X
 FXWXWX XWX 
XX   XFWXXWF
XWXFS  WX   
 XFX XWX X F
X   XXXXX XX