  XXXXX XXXX
X  XXX X XXX
X   XXXX XXX
XX XXXXXX X 
X  XXXX   XX
X  SXXX  XXX
XX XXXX X  X
 XXX XXXXXXX