X XXX XXXXXX
XXX    X  X 
 XX  XXXX X 
XS  XXXXXX X
XX XXX XXXX 
 X XXXXXX XX
XXXX  XXXXXX
 XXXXXX  XX 