WFWFXWWX F A
FXWXFX FXF  
 X F WXXXWXX
XWSXWWFFXXXF
F XXF FAWWX 
 X AX WXXX X
XXWF XWF XF 
XF   FWFX XX