  XX XXXXX X
XXXXXXXX    
 XXXXXXX  XX
XX XXXSX XXX
XX     XXXX 
 X XXXX X  X
   X  X XXXX
X X XX XXXXX