  WW X  XXFW
FWWXWFX XX X
W X  F XXFFX
XXXXWFFXWXW 
XFXW F WFSXW
 F W F XXFXF
 WWFXXWXXX  
XX XXWWX XWW