X WA   AF  X
XW FWXWF WXW
 FXXFXXXXXXF
WFXFWX FF  X
XFFXXXF XXXW
FFFW WXFXFW 
XWWFF WSXXFA
F  FWWWX XXX