 C X X XCC  
CX X  X X CX
   C C CSX X
C XC  C X  C
 CXCC C C XC
C  X XCXCCXX
 C   XC C CX
X XX  XXCXXC