 XXXCXCCCCCC
XXC C CXXC  
XCC    XSX X
C XXCX CCCC 
 CCCCXXC  C 
 XC XCCX XXX
C  CXCXXCXXX
CXX  CXXCX  