F XXXXFXFXX 
 W  XWFWWA X
 XXXXWX SWXX
 XXXX   XXX 
XWXF XWFXXFW
 XA F XX XXW
XX X  XF XX 
XXFF FX XFFX