XWWAWXX   XX
    XWXWXXWA
WXXXXXXXAXXW
X W   SX WWX
 XX  XW  WX 
 XWAXA W WW 
XW XWX   W X
XWX   XXXWWX