CXXX C XCCC 
XX    XXCXXC
XXCX C  XC C
 XC  CC XXCC
CX CCXXXC XC
CX   C CC CX
  XSXCXXXX X
C  CCXXXCX C