FXWX   XFFXX
FWXA XF XFFX
XFW X XFWXXX
F XAFFW FAX 
 WXFXWXWW WX
F A  F WSXWW
WF  XAWX FXX
XW  X WXXWF 