    XCX XXCC
P HCCXPPX HP
 H P X C CSH
CHXCCC H  PX
PXC  PPCCC  
   HXX HCCCX
 HXHPHC CH  
CXX P PCX CX