 FWF XWWXXX 
XXXXX XXFFXX
WF FW FF WSW
XX F WFXWXFX
 F FX  FXXXX
 XFXWWXXXFF 
X WFFWXXFWXX
FX  XXWFFW X