FWXF F WWX F
WXX  XX S WW
X   X XFFXXF
XWWFXWWX FXF
XFWXX FFFXXW
FWWF XWX  XX
WXF W  WXX  
X  XFW WFFWF