XW WXXX  XX 
 XX XX XXX X
WW WXXXW WX 
 AX WSWWA WX
WXXXX  X XX 
AX AXAA  XW 
W XXXXXXX XX
XX WXXW XX X