 H CHHC CCCC
H CH HHHHC C
 HH  HHCCCCC
H HC C  CHH 
  CCHH  HCH 
H H  CC   C 
 CCCC SCHCCC
CC H CCH C  