CCCX XXC XC 
X XXXXX X X 
XXX XXC XXXC
 X XXX CCXCX
CX CXXS C  X
  CXCXXXXCX 
CCXX C XC C 
XXCXXCX    C