 C XCHCCHCCX
 PXXP HCXPH 
HP XH CSXXHX
 P  H CX PC 
HCH XHPPCHHH
 X   XCC XPC
CH CX CHCXH 
  H PCX PHCX