W PPHWCHX   
 X CX  X HX 
CH P  CW XFF
 P  SX  FCHH
CWCWX  P   C
FH XPHH X WW
 WCXH XC XP 
PFCFF  C XHH