X   CC X CCC
 C  CXCC XCC
XCX CXCCXX  
XX C X  CCXX
CX CCC CXXCX
 CC SX CCXX 
C CCXCXXCXCC
X XXCX C C C