CHH      CCH
 HSHHCHHCCH 
C HCHCCCH CH
CC  C H H H 
C CH CC H CH
  HH HC   HH
CCCCCHC  CH 
 H    HCC HH