HXCCX X X  P
CXHHXXC XXC 
XHXXC C C C 
XX SP CX  C 
 HC  H H PC 
HXHCC HHHC X
C C X XHP   
X CH HHH HX 