XXXC CXXXCXC
  XXCX CC CX
X CX SC    C
 C XCCCXCXCC
X  C XXCC CC
CXX  CXCCC C
CCCC  CX  CX
 CC XCXXXC  