  X WAXAXX X
AXXW  A    X
 W  XW XX X 
XXX XXXWAXXX
W  AXXXWAWWX
W   XS  XWXX
 XW X W  AWX
AWWXXXXXXXWW