WWXWX XW  XX
WXXXXXXW XXW
AWXXA  XW   
WX X S W XXA
 WW XWWX AX 
X XWWW XXWWX
WXWXX XXXWXX
 WW X AAX WW