 CHPCXC HP X
 X XCPP    H
P C  HHXC XP
HHH CXXXPXHC
CP    HSCH C
XCXHX XXCX  
HHHXHPPHXHX 
C  CX PX  XC