W WX   FWFW 
XF XX XXFWW 
 WXWWWS WWXX
X F X XFFXW 
X  F XX WWF 
FX XXXX FX  
 XX  WFXXXFX
XXF  X  W F 