 XXXX  XXX X
 XXX X XXXX 
XXXXX   XXXX
XXXXXXX  XXX
 XXXXXXX XXX
XXXXXXXXS XX
   XX XX  XX
X XXXXX XXXX