XX CC XXCCXC
X XCCX C XC 
   C SXCX XC
C CX CCXCC C
X  CXCX CX C
XXCX  X X CC
 X XX CC   C
XCCCX XCX XX