 X FXX XXWFX
  XX X FXW F
F WX FWWXW F
XX    X FWFX
FXFXX  WWXF 
W FW X  S X 
 XWWWWFX X X
  F FXW XXXX