WFXF XXXXXF 
 X   WXSF XX
   FXXXXXWAW
WXWF WFX FW 
 XWFXWX F X 
W  XX XFX WF
    XW XFX F
 XAWXFXF X  