    C  CHHHC
HC HHHHCH   
HHCCC HCH  C
   HHCCC HHC
CCHHHSCHCC C
CC CHHCCHHCH
C H HH  HHHH
 C  CHH HCHH