C  H H C  HH
CHHHHHHCHHCH
  HHCCCHCHCC
C CC C CCC C
H H   CCCHH 
 CCCCHS HHC 
 H CHHCCHH H
 H  CHCCCCHH