XX XXXXXXXX 
XX X XXXXX X
XX   XXXXXXX
X  XXXX XXXX
 X   XXXX X 
XXX SXXXX  X
XXXXXX XXX X
XXXXXXX XX X