X   X XXXXXX
X XX X X  XX
 XXX X     X
XXX XX XXX  
XXX XXSXXX X
X XXX XX XXX
 XXXXXXXX   
XXXXXXXXXXXX