FX AXWX XW F
X FXF SXX WX
X XXWW XXXFX
XWXXXXFXX  F
WF F   W X  
XX  X XAXFA 
 XXFX XFXFXX
AX X XFXAFXX