WXX XXXWX WW
FW X XFXXFWX
X  XFW XXF F
FF   X FXFWF
FX XFX  XX F
XFF  WWFSX  
FXF WXFXWWWX
FW WWFXX  X 