P WXHFC HF  
HWHH CHC CCF
WCPSXH  CFCC
C C W FXC  C
HFFX  HXF F 
CW HX CHF F 
HCXXPHCF PWC
WXCHP    HH 