XXWXXXWX WX 
X WXXXXXXXWX
WXXAWAWAX X 
 WWXX AXWXXW
XXXW XS WWW 
 XWX XAW XX 
AWW X XXXAW 
WW WAXXX WXX