XXCH  HXXH P
 CHCX X  PCX
C CC H HH C 
C     XPPC H
XHX XHX    H
X  PXPX PSC 
CC HCPHH  XP
  HXHXHXXPXH