 H CCH HH   
CHC CHCCH HC
CH H CHCHH  
C CHC C  CHH
  HC HH CSHH
CHH CH HCHH 
  HH   CCCC 
HH HCHHHCC C