  XH  PHX XC
 PXPXH HC P 
 XC XHC HXH 
 C X  CHCXXX
HXX HHH HC C
XHPX CC C  C
PXCC  SPCC H
CC  CPCH  HP