A   AWX  XWX
W X  XAXXXXX
 XXXXXSXXXX 
X  A   W XWW
XXA XX  WW  
X X X XWWW  
WW XW  XX WW
 X WXAX X  X