    W XFF XX
 WFX WWF XW 
W X   WXFWWX
WX  WFSXF  W
X FX   XWF X
 XXF   X XXX
XFWWWXWXW XW
XXXXFWXFW XX