CXCCXC  XCC 
XX CX XC C  
XC  XXX CX X
 XCXCXXCC   
 XXXCCC CX X
CCXX CCS XC 
XXXC  CXC XX
CCX C   X X 