XX XX X  X  
XX X XX XX X
X  X     XXX
  XX X XX  X
 XXX XX XXXX
XXXXSXXXXXXX
 XXXX XX X X
  XX XXXXXXX