F XF WXC  CH
 XC XF  XCXX
XHC  PCP XP 
 C XCP  CH C
  FX F  XSPH
 WCX   CX C 
WW XHX   H W
X P XFWCWCHP