XW XXFXXX W 
 XXFXXWX X  
FWFX FSW X  
F W  WWWFXXW
 WFW  W    W
WWXW WXX XXX
WW  X XXFFFW
F WWWFWX X X