F WX W FF   
WWXXXWXXFW F
FFXF XXWW XX
 FXAW FXXWXF
 WFXSXW WFXX
FF X FWXXFF 
WW XXX    X 
X XXFX  FFXA