XF W X XX XX
XF  X XXXFWX
XFFWX X  XFF
FFXWF  FXX W
W W SFFXFXFX
 W X XX XXXF
WXXWWX XWX  
FWFWXXWWF W 