CC HC H HC C
HHH HXHXHH H
XH H C  P CX
HHS CX CC CX
  HH CHCC HX
X HHPPX HCCH
  CXHHHPHPCX
H  PCPPCHCCX