 WWXF XW W W
  XWWWXWX X 
XX  FFX    X
FXWWSXXWX XX
 WXXW  FXW  
   W  FX  XX
  FX WXXWFF 
F  XXX XFFWF