 X X  XXX XX
 WXSX XX WXX
AWXAXXWX    
WW WAWXXX  W
 WXWXXWW    
X  A W A X W
WXXXW AX WXX
 WXXX W  WXW