 HC C HH  CH
C  HH C HCCC
HCCCHH HCCCC
H C H C C  C
 HC  C C HH 
 CHH CCC CC 
HHSC HC H   
  CCC  C C  