C  CCCC  C  
 HHC CH CC C
  C HHHC CH 
CHSC HHHHHC 
 CHCCCHCH HH
HCCH   HCCHH
CH H HH  CHC
HCC C C H   