X  XWXXXXXX 
 XXWXW AXX W
X  X SAXWWXX
XXXX XXAXXW 
WW X AX X  X
AXX XWXXWW X
XX W WXWWWW 
 X WXXWWW  X