X XA XXXXX W
XXX X X  XX 
AW X  WXXX X
XAXWW WSX  W
XXWA XA WXXA
XW WWX A  X 
  X   XXXXXX
X  WX  XXXXX