 F FWXXXX FW
XX F W XFX X
 FXX W  XX X
FWFF X FXFXW
  WWX FXWXX 
FW  X   WSXF
 XX  XWFXFFX
F WFWWXX WW 