CCX CCCC  CX
XXC    CXC C
 XX  C XCCCX
C XXXX C  CC
CCXXCCCXXXX 
    X  CC CX
XC C XS XCX 
XCX CXCC C  