HHCHH C   CH
 HH    CCH C
  HCHCH HH H
C HSH HC HCH
H CHCCCCC HC
CCHHH    C H
  HHH  H CCH
   HC CHCHH 