 W FXXX X  W
XFXWA XXXXW 
 WW XXXXWXX 
XXF XWX XFX 
XXX XXX  XXA
XSFW F   FXF
FXX XXA  XWF
   W FW X X 