C CCH C HHHH
HCH CHCH H H
CC SC HH CHH
 CCHHH   HHC
HCHHHCC  CHH
CCH   CCC   
HCCCCCH  CH 
 H CCCCHC  H