C XX CX XXCX
   CXCXXCX X
 C C XXXCXXC
C C CS CXC X
CXX CXX CX  
XXCC XC CXC 
CXXCCC   CXC
X  XC  XCCC 