XX XXX XXXX 
X XXX      X
 XXX XX XX X
 XXXX XXS  X
     X XXXXX
X XXXX  XXXX
XXXX  X  XXX
XXXXX XX XXX