FXFXF XW  FW
X X F  FXWWF
X X XXXFF X 
WWXXXXXX W  
WXXWS WFW  X
 XFXFX WF   
XW F XWWXX X
X WWW W FF  