XXXXX XXXX  
  XX XX    X
XX X    XX X
X  X    XXXX
XXXX XXX XX 
X  X XXXX   
XX  S  XXXXX
XXXXXXXXXXX 