HCC  CHHHHH 
 CHC H CHHCC
HH H HC H HH
 CH HCSHC H 
HCC HCCH  HC
 HH C CCCC H
H HH C CHHC 
H  CC H C H 