CCCX CCXXCXC
   X CXC X C
X CCXSXXCXX 
CC CCCC C  X
C XXX CXXC X
 CCC  CCCCCX
  C C XX CCX
CXXX CX X CX