  XXFFW  XW 
WW  W XXX XA
XF XXW SX  F
 X A WFFWW X
XXFW XWXXFFF
 FXWF WWX X 
X  FX  X XFW
X FAXWXWWXW 