X CXCCXCCXX 
X CCX   C SC
  XXXCCCX CX
C      XC CX
 XX XC CCXXX
 CXC   CXCCC
C XX X CX  X
CXXXCXXXXXXX