HC  CH HCPXX
HHC XHCHH  X
XH  C   HH P
  H  CHX S H
P C CX CHCCX
HXPCHPXHHX C
HH  HP XX  P
 XX X HXC H 