HHX WXFHPH  
  F HW C XH 
FP XSHWXHXX 
WFCX  PPCC  
FHXCHWW  H H
CHC    HHCWH
C  CPPX  WWF
FHH WFCH W  