 CC HHP C X 
PHP C XHX  C
H  XXXX XXXH
 P HH C   PH
 H   X XSXPC
PHCP HHXH X 
 HCHCH P HPX
  PXCXCCCC  