XXX  C XXXXX
XXCX XC CCCC
  XXXX   XX 
   C CXCXXX 
XXX CC CCXXC
XXCSC    XX 
XXXX XXC  CC
 C  C X   XC