  WFFX WX  X
FX XXWWFXWW 
X XSX X WF F
W  FWXX  XFX
XXW XF WF X 
 X   WF XX W
WWXXFWWXXX W
XFXWXWXXXXWF