W X W XX XX 
XXXXXXXWXWXX
 W WWA WXXXW
XXXX WSXWWX 
XX     XAWX 
XXXX WWAWXXW
XXXAW XXW WX
XXXXXXXW XXX