W FHXCFPXWW 
XWWHXHCH  PX
FH XXPHC PPP
P  XPW XW  P
PWSFWFWW WXX
 HWH CHWX HX
  PHCPX PPCC
 HXH  XHCWWH