AWXWXX XXXXX
 XXXA XXXW  
XXX XA WXAX 
 XXXX WAX XX
  X XXSAXWXW
 WXX WWXXX X
XWX WWXX WX 
W XA X XX  W