HX HHCHPHH H
C C HHH CH  
 PCP C CX XC
CXPHX  XXC H
XXCXCH C  XP
PXXHXSHC HHH
HHXPCCH XPXH
PC X HHC HC 