X  CCCXCCCCX
  XX X CXC X
C XSC  CXCXX
XXC X C XCC 
CXC  C X X X
XXXCCCCXCX  
XCXXC   C  X
X CCXC X  XX