CX XC XX CX 
CC CC C   C 
XC C CX XCXC
XCXXC XCXXCC
CXCSC CCCCXC
X   X X CCX 
CCCCX XXX XX
XXXCCXCCCCCX