 XX X X XXXX
X XX  X XXX 
 XXXXX  X   
X XXXXXXXXXX
X X S    X  
 XX XXX X XX
X XXXXX  X X
XXXXXXXX  XX