HH CH HCC HC
HHC  HHCCC  
H HHHC C    
C H CCH HCC 
C  CHH  HH H
HCH  CH SHHH
CCC  CH  CH 
CCCCHHHHCC H