X XFXW WXFF 
XFX XWXXWXXX
XXW X  SXFFW
 XF X  XWFWX
 FXXF W AFW 
 FFXWW  XXWF
 FXX WXXXFXF
X   X  X   X