X  XXXX X W 
WXXXXXWWAW W
 XXS  XX X X
W XX AXXXW X
XW W  AXXXXW
X WAXXXW  XA
XX  X XWW  X
W XX XXXX XX