 CXXCCXXX C 
XXX XCCCCXC 
 C SC    X  
CXC  X XXX  
CXCCXXCXX CX
X C     C X 
 C X C    C 
 C C XCXC  C