H  PHXHWX  C
   XH    PXP
CHCCC X  FPP
XCWHFWW  C H
 PXPFFX XFHC
CPXC XXXC  W
 CHWSX X WH 
  HCH PHXH X