XP XCH  XXXH
H XXHXXCW  W
X XCCX F H X
XHFHPXPX X X
XXHH C PXP C
 HHH S XXP W
FXCHXHW P XC
CXW WF XCCH 