XXXXWXXAXXWX
XWXXXXW XXX 
 WXS AXXW  X
XXWA  X  XWX
W WW AX  WXX
X  XXX X W A
XXXXW WXXX  
XW XWXX XXW 