XW WXXWWWXXW
 X XX X XXWW
  WXX WWXXX 
 XXXWXA WXXX
 X XWXWXS AX
  WXX X XXAX
X  A XWX  XW
 XWXXXWWXW X