X F XP  HXXX
   XC CPFXXX
CXX CWH P WC
 C   XX HHWX
XCPCCFXPCHXH
 F XPHCCX WH
 HH CC CS XC
 HH CC WPWCW