XX X   X XXX
XXXXXX  X X 
XXXXXXXXXXXX
XXXXX     XX
X  XXX X    
XXXXXXSXXXXX
XXXXXXXX XXX
X   XX X XX 