XXX WFWWX W 
XX  F XX  XX
WWXWXXF WWX 
 XX XS XX FX
XFWX  X WXW 
WWW  WF  F W
WXWFWX FXFW 
 FXWXFXWXX  