WX W XWXW X 
 XX   XX  X 
F XXXW WFWXX
F FFWF XW XF
WFXXXFS X  W
XFX WXWX XXX
  XX   X  W 
XXX WXXXWW  