X XXCCCXC X 
CX  X XXX X 
XCCC X C C X
 C XXCCXCC X
CCXC  XXXXXC
CCSC C XCXCC
 CX  C      
CC XXCX XX C