CHCCCCCHC C 
CCHHHHCHHHHH
HHCCCCH CC C
 HH CHHCH HC
HCCCH HHC HH
HS      H H 
CCCCC  HCC C
 CH CHCCC  H