FXFWXXX X W 
 W XAFWX WXX
WXXXF  XXXX 
  FFX WXXXWX
X X   WSFXWF
FWWXFXXFXXXW
F XXWXXWXWX 
X F WXXXA  X