HXHX XHHFP  
 C H PC WW  
FH PPSHCCFWH
  CC   C  PP
WX PXCHCHWC 
CCHFHH X HHC
C PF CC X  P
CX    CF   X