X    CC   CX
XX CCX X C  
CCCC X XXCX 
XXX C CCX   
X CXCX XXCCX
CCSC    XXXX
X XXXXC CCXC
C X   XXXX X