X  XX   X  X
  XXXX X X X
XXXX XXXX XX
XXS XX XX X 
 XX X XXX  X
X X   XXX XX
 XXXX XXX  X
 XXXX XXXX X