XX X W    WX
XX XX XWFW W
FXXFFSFXWWF 
WXWWXF W FXX
  FWFXXXXXXF
XFWXX  FFXXW
WFXFXXFXXWFW
WWFWXX FWXFX