CC P XHHHXHP
H X HX HH XX
PPHXXH   C X
X XSCCP PXXX
PCCCX  C CXX
CHC  X H P C
PHH H CCC CH
P X XPC X CH