PHPPH HHXXCH
C CS X X CHH
 XHH CHHC C 
XP XHHC XPHC
 PHX XHH  HH
 H HX  H P C
CCP XPPH CHP
 X XCPCXCC H