CHC CPHCXXHX
C XCXHHCC XX
XX PC  PXPHH
PCX C HX HHX
CHXXXHCP HHP
CHX XCCXCH C
  CCXCP HHSX
CHCHHHXXPCHX