WXX WWWX   W
 WFXXFX FWFX
 XXWAWW XFXX
X W XFWX    
AXXXX FSXXXX
 WWFXXXXX   
W  XX X XX F
XWW XXXFXX X