 C C CHCHCCC
HHCSCH C CCH
CC C HCHCCH 
CCC CHHHHCCH
H  CH HHHHH 
HC  HCHHCCCH
H H H  C C C
  H HH H  H 