CW HC  X HPX
  C  PCX CFC
 HP  C  F XP
XCXH P WWX C
 HP XX CHH  
H XH CC WH X
CXCSHCHC  HW
 PXC FFHCCC 