CHC X HXHXXP
CC  CC H XPX
XXXCHCX SHPC
XHHP  C PHCC
HPP XHHPXX  
 HH XCCX HC 
   XHHHHPCXH
 X HH  XPHXC