XW F FXXXF  
 X XFX  FX X
XFXXX S  WXF
 X  XWXFW XW
 W  X  XXWXX
 WX   FXF WF
FXW  XW FFXX
XX XWX WX XX