FXFW XXWXXWW
  W XS XWWFX
  XXFX  AWX 
F XXFX  XW W
XFWFXFFXW W 
X XXFXXF FFX
XXXWWXFFFXXA
XF WFXWFXW X