 W X X X X X
X XWXXXXXXXX
X  W WXSAWX 
X WX A WXXXW
 X  WWWX WXW
X XAXWWXX AX
WXXWW WX WXA
X X XX WX W 