X XXX XX  XX
X XXX  XXXX 
XX   X  XXXX
XXXXXXX   XX
 XX XXXXSX X
X X X XXX XX
 X  XX XXXXX
XXXXXX XXX X