AFWA X XXX F
X XWWXXXFWX 
XAXFFXFXF AX
FFXSW   FWX 
XWWWX XA XFW
XX W F X WXF
XFWX XFWXW X
   XXXWX F X