WXFW FXXXFFX
W WWX XX    
X XFWXXWW W 
 XX     FFWX
WX WWXFWXFXX
FX XFFXSFXXX
 XXW XWXXWX 
XXXX XXXX F 