HCCHH CHHHCH
 HCC CC CCC 
HHHHCH H  HC
HHH  CHHCCHH
H CH HHHH   
CHCCHH  CHHC
H    C HSCHH
HCH CH CCC  