XXX X   X X 
  XXX    XXX
  XXXX XXXX 
X     XXXXXX
X XX  SXX XX
X XXX XXXXXX
X  XXXXXX XX
 X XXXXXX XX