 X XX XXX XX
X XXX    XX 
XXX X XX XX 
  XXXX   SXX
XXXXXXXXXXXX
 X XX X XXXX
 XXXXXX  X  
 X XX X X  X