 X X XXXX XX
X XXX XXX  X
X   XXX XXXX
XX  XX     X
XXXXX  SX X 
XXX   XX   X
XXXXX XX XXX
 XXXXXXX X X