  X XXXWW  X
 X XX XXXWAX
WXA XAXX WXX
  XXX  X AX 
XX  WX X W A
X WW S X   X
XWWAWWXX WW 
XX XXXW  XA 