FF X  XX  FF
 XWFXAFWXX F
X WXXXX W FX
F FXWFWW W X
X WXASWFXWFX
XXFWXWX X WW
 WWXFXXXWF F
XFWW AX   XF