XXX XXXX   X
X   XXX XXX 
XXX     XXXX
X XXXXX  XXX
X X XXXXSXX 
X XX X XXX X
XX  X XX   X
 XXXXXXXXX X