CHCC CCH HHC
CH  C  CH  H
  H  HCCCC C
CCHCCC CCC H
CH HHSCH HCH
   CHCHHHHCC
  CC   H C H
H CCHCCH    