 C H  C  HHC
W HXPCXCFHC 
XCPW HHH X P
FXF   PFCC W
 PFX HHC H W
FX HHSCW PXF
  WCHPH  CW 
FFHH H PF XF