XFWX WWXWFXF
XXFXXWXXX W 
XW  SW FXFWW
XXXWFX   XXX
XF  FXXWXWX 
 XXXX FF XFX
 FXW  W  XFW
FXXWFXWXXWFX