 XH   C HX H
  X  HHH XHX
PHPCX  C CHC
 CPCXC HHHX 
CX HCSXHH  C
X XHXXHCCC  
  H C H CXHH
CHX CCC CHX 