XWHXWFPFHP X
 CF XFC  XC 
CXFXXCX  HHW
 WC WX  P H 
CPCCX PCXPP 
C PFPCS  CX 
C  PXWW H  C
 CH X  PCC H