X P C PXPCXC
PH CXXXH XCH
H XCX   XC C
HC   CCS C H
CHHXCCXXPHHH
  PXCX C   C
C CHHPHX H  
H PC C HH   